
        ______ _   _ _   _ _____  _____ _____ _   _ 
        |  _  \ | | | \ | |  __ \|  ___|  _  | \ | |
        | | | | | | |  \| | |  \/| |__ | | | |  \| |
        | | | | | | | . ` | | __ |  __|| | | | . ` |
        | |/ /| |_| | |\  | |_\ \| |___\ \_/ / |\  |
        |___/  \___/\_| \_/\____/\____/ \___/\_| \_/
                                            
            _  _  _  _  _       _      ___  _  _
           |_||_||_ |_ |_      |_ |\ |  |  |_ |_|
           |  |\ |_  _| _|     |_ | \|  |  |_ |\





